W W W W W W W W W
W E E E E E E E W
W H E E T C E E W
W E E E C E C E W
W E E E E E E E W
W W E E E W E E W
W E E T E W W T W
W W W W W W W W W